map1

3
10
10

0 0 0 0 0 0 0 0 0 0 
0 1 0 0 1 1 1 0 1 2 
0 1 1 1 1 0 7 0 1 0 
0 0 0 1 0 0 0 0 1 0 
0 0 1 1 1 0 0 0 1 0 
0 1 1 0 1 1 0 0 1 0 
0 0 0 0 1 0 0 0 1 0 
0 0 0 0 1 0 0 0 1 0 
0 1 1 1 1 1 1 1 1 0 
0 0 0 0 0 0 0 0 0 0 

0 0 0 0 0 0 0 0 0 0 
0 0 0 0 0 0 8 0 0 0 
0 0 0 0 0 0 6 0 0 0 
0 0 0 0 0 0 5 0 0 0 
0 0 0 0 0 0 4 0 0 0 
0 0 0 0 0 0 3 0 0 0 
0 0 0 0 0 0 7 0 0 0 
0 0 0 0 0 0 0 0 0 0 
0 0 0 0 0 0 0 0 0 0 
0 0 0 0 0 0 0 0 0 0 

0 0 0 0 0 0 0 0 0 0 
0 1 1 1 1 1 0 0 0 0 
0 1 0 1 0 0 0 0 0 0 
0 1 0 1 0 0 0 0 0 0 
0 1 0 1 0 0 0 0 0 0 
0 1 1 1 1 0 8 0 0 0 
0 1 0 0 1 1 1 0 0 0 
0 1 0 0 1 1 1 0 0 0 
0 1 0 0 0 0 0 0 0 0 
0 0 0 0 0 0 0 0 0 0 

1 4 7 