map3

1
10
6

7 0 0 0 0 0 0 0 0 0 
2 1 1 1 1 1 1 1 1 0 
0 0 0 1 1 0 0 1 1 0 
0 0 0 1 1 1 1 1 1 0 
0 0 0 1 1 1 0 0 1 0 
0 0 0 0 0 0 0 0 0 0 

1 2 2 